30 Minutes - T.A.T.U..wma
A Journey of the heart - Karunesh.wma
And So It Goes - Billy Joel.wma
another day in paradise - phil collins.mp3
Be Without You.mp3
Beyond the game.mp3
Born To Try - Delta Goodrems.mp3
CHILDHOOD MEMORY - Bandari 班得瑞乐团.mp3
Don't Love You No More - Craig David(克雷格大卫).mp3
everytime - britney spears.wma
Fly - Hilary Duff.mp3
God is a girl.mp3
HALO - Bethany Joy Lenz.mp3
hero - Enrique Lglesi.mp3
hips don't lie - shakira.mp3
Hot Stuff - Craig David.mp3
How It Feels - Sophie Zelmani(苏菲珊曼妮).wma
if i were a boy - Beyonce.mp3
If you feel my love - Blaxy Girls.mp3
IT MATTERS TO ME - Faith Hil.mp3
light from a dead star - lush.mp3
My Life Would Suck Without You - Kelly Clarkson.mp3
No One - Alicia Keys(艾莉西亚凯斯).mp3
no promises - shayne ward.mp3
One Last Dance - Craig David.mp3
Pony - Erin McCarley.mp3
Promises Don't Come Easy - Caron Nightingale.mp3
RHYTHM OF THE RAIN 绿箭口香糖广告歌曲 - Cascades s贾.mp3
Send Me An Angel - Scorpions.mp3
She's not just a pretty face - Shania Twain.mp3
Someone Like You - Sissel.mp3
Someone's Watching Over Me - Hilary Duff.mp3
stuck in my heart.mp3
Tears In Heaven - Eric Clapton.mp3
Thank you - DIDO.mp3
To Be With You - Mr.Big.mp3
Traveling Light - Joel Hanson Sara Groves.mp3
Unfaithful - Rhianna.mp3
vincent - Don Mclean.mp3
